+--+--+--+--+--+--+--+--+--+--+--+--+--+--+--+--+--+--+--+--+--+
|        |        |                                            |
+  +--+  +  +--+--+  +--+--+--+--+--+--+--+--+--+  +--+--+--+  +
|     |     |        |     |     |              |     |        |
+--+  +  +--+  +--+--+  +  +  +  +  +--+--+--+  +--+  +  +--+--+
|     |  |     |        |     |  |        |  |  |     |     |  |
+  +--+  +  +--+  +--+--+--+--+--+--+  +--+--+  +--+--+--+  +--+
|  |     |  |  |  |              |  |  |     |        |  |     |
+  +--+--+  +--+  +  +--+--+--+  +  +  +  +  +--+  +  +--+--+  +
|        |  |     |     |     |  |  |     |     |  |           |
+  +--+  +  +  +--+--+  +--+  +  +--+--+--+--+  +  +--+--+--+--+
|  |     |  |        |     |  |              |  |           |  |
+  +  +--+  +--+--+--+--+  +  +--+--+--+--+  +  +--+  +--+  +--+
|  |  |                    |              |  |     |  |  |     |
+  +  +  +--+--+--+--+--+--+--+  +--+--+  +- +--+  +  +  +--+  +
|  |        |     |                    |  |     |  |     |     |
+  +--+--+  +  +  +  +--+  +--+--+  +--+--+  +  +  +--+  +  +--+
|  |        |  |  |     |        |  |        |  |  |  |  |     |
+  +  +--+--+  +  +--+  +  +--+--+--+  +--+--+--+  +  +  +--+  +
|  |  |        |     |  |     |     |           |  |     |  |  |
+  +  +  +--+--+--+--+  +--+  +  +--+--+--+--+  +  +--+--+--+  +
|  |                       |  |     |  |  |     |        |  |  |
+  +  +--+--+--+--+--+--+--+--+--+  +--+--+  +--+--+--+  +--+  +
|  |        |     |  |        |  |  |  |              |  |     |
+--+--+--+  +  +  +  +  +--+  +--+  +--+  +--+  +--+--+  +  +--+
|     |     |  |  |  |  |  |        |  |  |     |     |  |     |
+  +--+  +--+  +  +  +  +--+--+--+--+--+  +  +--+  +  +  +--+--+
|           |  |  |  |                 |  |  |     |  |        |
+--+--+--+  +--+  +  +--+--+--+--+--+  +  +  +--+--+--+--+--+  +
                  |                 |     |              |      
+-----+--+--+--+--+--+--+--+--+--+--+--+--+--+--+--+--+--+--+--+